0 0
6 400 400 10 15 1 10 15 1
3 500 600 10 0 0 10 0 0
3 700 200 10 0 0 10 0 0
3 100 800 10 0 0 10 0 0
4 2000 950 5 10 2 5 10 2
4 900 2000 5 12 1 5 12 1
1 1500 1500 20 0 0 20 0 0
5 1000 1000 1 0 2 1 0 2
